NOM_DU_LOGICIEL_UTILISE_1	public class NOM_DU_LOGICIEL_UTILISE_1 extends Rubrique { final RubriqueType type = RubriqueType.NOM_DU_LOGICIEL_UTILISE_1;}
NOM_DE_L_EDITEUR_2	public class NOM_DE_L_EDITEUR_2 extends Rubrique { final RubriqueType type = RubriqueType.NOM_DE_L_EDITEUR_2;}
NUMERO_DE_VERSION_DU_LOGICIEL_UTILISE_3	public class NUMERO_DE_VERSION_DU_LOGICIEL_UTILISE_3 extends Rubrique { final RubriqueType type = RubriqueType.NUMERO_DE_VERSION_DU_LOGICIEL_UTILISE_3;}
CODE_DE_CONFORMITE_EN_PRE_4	public class CODE_DE_CONFORMITE_EN_PRE_4 extends Rubrique { final RubriqueType type = RubriqueType.CODE_DE_CONFORMITE_EN_PRE_4;}
CODE_ENVOI_DU_FICHIER_D_ESSAI_OU_REEL_5	public class CODE_ENVOI_DU_FICHIER_D_ESSAI_OU_REEL_5 extends Rubrique { final RubriqueType type = RubriqueType.CODE_ENVOI_DU_FICHIER_D_ESSAI_OU_REEL_5;}
NUMERO_DE_VERSION_DE_LA_NORME_UTILISEE_6	public class NUMERO_DE_VERSION_DE_LA_NORME_UTILISEE_6 extends Rubrique { final RubriqueType type = RubriqueType.NUMERO_DE_VERSION_DE_LA_NORME_UTILISEE_6;}
POINT_DE_DEPOT_7	public class POINT_DE_DEPOT_7 extends Rubrique { final RubriqueType type = RubriqueType.POINT_DE_DEPOT_7;}
TYPE_DE_L_ENVOI_8	public class TYPE_DE_L_ENVOI_8 extends Rubrique { final RubriqueType type = RubriqueType.TYPE_DE_L_ENVOI_8;}
SIREN_DE_L_EMETTEUR_DE_L_ENVOI_9	public class SIREN_DE_L_EMETTEUR_DE_L_ENVOI_9 extends Rubrique { final RubriqueType type = RubriqueType.SIREN_DE_L_EMETTEUR_DE_L_ENVOI_9;}
NIC_DE_L_EMETTEUR_DE_L_ENVOI_10	public class NIC_DE_L_EMETTEUR_DE_L_ENVOI_10 extends Rubrique { final RubriqueType type = RubriqueType.NIC_DE_L_EMETTEUR_DE_L_ENVOI_10;}
NOM_OU_RAISON_SOCIALE_DE_L_EMETTEUR_11	public class NOM_OU_RAISON_SOCIALE_DE_L_EMETTEUR_11 extends Rubrique { final RubriqueType type = RubriqueType.NOM_OU_RAISON_SOCIALE_DE_L_EMETTEUR_11;}
NUMERO__EXTENSION__NATURE_ET_LIBELLE_DE_LA_VOIE_12	public class NUMERO__EXTENSION__NATURE_ET_LIBELLE_DE_LA_VOIE_12 extends Rubrique { final RubriqueType type = RubriqueType.NUMERO__EXTENSION__NATURE_ET_LIBELLE_DE_LA_VOIE_12;}
CODE_POSTAL_13	public class CODE_POSTAL_13 extends Rubrique { final RubriqueType type = RubriqueType.CODE_POSTAL_13;}
LOCALITE_14	public class LOCALITE_14 extends Rubrique { final RubriqueType type = RubriqueType.LOCALITE_14;}
CODE_PAYS_15	public class CODE_PAYS_15 extends Rubrique { final RubriqueType type = RubriqueType.CODE_PAYS_15;}
CODE_DE_DISTRIBUTION_A_L_ETRANGER_16	public class CODE_DE_DISTRIBUTION_A_L_ETRANGER_16 extends Rubrique { final RubriqueType type = RubriqueType.CODE_DE_DISTRIBUTION_A_L_ETRANGER_16;}
COMPLEMENT_DE_LA_LOCALISATION_DE_LA_CONSTRUCTION_17	public class COMPLEMENT_DE_LA_LOCALISATION_DE_LA_CONSTRUCTION_17 extends Rubrique { final RubriqueType type = RubriqueType.COMPLEMENT_DE_LA_LOCALISATION_DE_LA_CONSTRUCTION_17;}
SERVICE_DE_DISTRIBUTION__COMPLEMENT_DE_LOCALISATION_DE_LA_VOIE_18	public class SERVICE_DE_DISTRIBUTION__COMPLEMENT_DE_LOCALISATION_DE_LA_VOIE_18 extends Rubrique { final RubriqueType type = RubriqueType.SERVICE_DE_DISTRIBUTION__COMPLEMENT_DE_LOCALISATION_DE_LA_VOIE_18;}
CODE_CIVILITE_19	public class CODE_CIVILITE_19 extends Rubrique { final RubriqueType type = RubriqueType.CODE_CIVILITE_19;}
NOM_ET_PRENOM_DE_LA_PERSONNE_A_CONTACTER_20	public class NOM_ET_PRENOM_DE_LA_PERSONNE_A_CONTACTER_20 extends Rubrique { final RubriqueType type = RubriqueType.NOM_ET_PRENOM_DE_LA_PERSONNE_A_CONTACTER_20;}
CODE_DOMAINE_D_INTERVENTION_21	public class CODE_DOMAINE_D_INTERVENTION_21 extends Rubrique { final RubriqueType type = RubriqueType.CODE_DOMAINE_D_INTERVENTION_21;}
ADRESSE_MEL_DU_CONTACT_EMETTEUR_22	public class ADRESSE_MEL_DU_CONTACT_EMETTEUR_22 extends Rubrique { final RubriqueType type = RubriqueType.ADRESSE_MEL_DU_CONTACT_EMETTEUR_22;}
ADRESSE_TELEPHONIQUE_23	public class ADRESSE_TELEPHONIQUE_23 extends Rubrique { final RubriqueType type = RubriqueType.ADRESSE_TELEPHONIQUE_23;}
ADRESSE_FAX_24	public class ADRESSE_FAX_24 extends Rubrique { final RubriqueType type = RubriqueType.ADRESSE_FAX_24;}
SIREN_DE_L_ENTREPRISE_DESTINATAIRE_DU_COMPTE_RENDU_D_EXPLOITATION_25	public class SIREN_DE_L_ENTREPRISE_DESTINATAIRE_DU_COMPTE_RENDU_D_EXPLOITATION_25 extends Rubrique { final RubriqueType type = RubriqueType.SIREN_DE_L_ENTREPRISE_DESTINATAIRE_DU_COMPTE_RENDU_D_EXPLOITATION_25;}
NIC_DE_L_ETABLISSEMENT_DESTINATAIRE_DU_COMPTE_RENDU_D_EXPLOITATION_26	public class NIC_DE_L_ETABLISSEMENT_DESTINATAIRE_DU_COMPTE_RENDU_D_EXPLOITATION_26 extends Rubrique { final RubriqueType type = RubriqueType.NIC_DE_L_ETABLISSEMENT_DESTINATAIRE_DU_COMPTE_RENDU_D_EXPLOITATION_26;}
ADRESSE_MEL_DU_DESTINATAIRE_DU_COMPTE_RENDU_D_EXPLOITATION_27	public class ADRESSE_MEL_DU_DESTINATAIRE_DU_COMPTE_RENDU_D_EXPLOITATION_27 extends Rubrique { final RubriqueType type = RubriqueType.ADRESSE_MEL_DU_DESTINATAIRE_DU_COMPTE_RENDU_D_EXPLOITATION_27;}
NATURE_DE_LA_DECLARATION_28	public class NATURE_DE_LA_DECLARATION_28 extends Rubrique { final RubriqueType type = RubriqueType.NATURE_DE_LA_DECLARATION_28;}
TYPE_DE_LA_DECLARATION_29	public class TYPE_DE_LA_DECLARATION_29 extends Rubrique { final RubriqueType type = RubriqueType.TYPE_DE_LA_DECLARATION_29;}
NUMERO_DE_FRACTION_DE_DECLARATION_30	public class NUMERO_DE_FRACTION_DE_DECLARATION_30 extends Rubrique { final RubriqueType type = RubriqueType.NUMERO_DE_FRACTION_DE_DECLARATION_30;}
NUMERO_D_ORDRE_DE_LA_DECLARATION_31	public class NUMERO_D_ORDRE_DE_LA_DECLARATION_31 extends Rubrique { final RubriqueType type = RubriqueType.NUMERO_D_ORDRE_DE_LA_DECLARATION_31;}
DATE_DU_MOIS_PRINCIPAL_DECLARE_32	public class DATE_DU_MOIS_PRINCIPAL_DECLARE_32 extends Rubrique { final RubriqueType type = RubriqueType.DATE_DU_MOIS_PRINCIPAL_DECLARE_32;}
IDENTIFIANT_DE_LA_DECLARATION_ANNULEE_OU_REMPLACEE_33	public class IDENTIFIANT_DE_LA_DECLARATION_ANNULEE_OU_REMPLACEE_33 extends Rubrique { final RubriqueType type = RubriqueType.IDENTIFIANT_DE_LA_DECLARATION_ANNULEE_OU_REMPLACEE_33;}
DATE_DE_CONSTITUTION_DU_FICHIER_34	public class DATE_DE_CONSTITUTION_DU_FICHIER_34 extends Rubrique { final RubriqueType type = RubriqueType.DATE_DE_CONSTITUTION_DU_FICHIER_34;}
CHAMP_DE_LA_DECLARATION_35	public class CHAMP_DE_LA_DECLARATION_35 extends Rubrique { final RubriqueType type = RubriqueType.CHAMP_DE_LA_DECLARATION_35;}
IDENTIFIANT_METIER_36	public class IDENTIFIANT_METIER_36 extends Rubrique { final RubriqueType type = RubriqueType.IDENTIFIANT_METIER_36;}
DEVISE_DE_LA_DECLARATION_37	public class DEVISE_DE_LA_DECLARATION_37 extends Rubrique { final RubriqueType type = RubriqueType.DEVISE_DE_LA_DECLARATION_37;}
NOM_ET_PRENOM_DU_CONTACT_38	public class NOM_ET_PRENOM_DU_CONTACT_38 extends Rubrique { final RubriqueType type = RubriqueType.NOM_ET_PRENOM_DU_CONTACT_38;}
ADRESSE_TELEPHONIQUE_39	public class ADRESSE_TELEPHONIQUE_39 extends Rubrique { final RubriqueType type = RubriqueType.ADRESSE_TELEPHONIQUE_39;}
ADRESSE_MEL_DU_CONTACT_40	public class ADRESSE_MEL_DU_CONTACT_40 extends Rubrique { final RubriqueType type = RubriqueType.ADRESSE_MEL_DU_CONTACT_40;}
TYPE__41	public class TYPE__41 extends Rubrique { final RubriqueType type = RubriqueType.TYPE__41;}
SIREN_42	public class SIREN_42 extends Rubrique { final RubriqueType type = RubriqueType.SIREN_42;}
NIC_DU_SIEGE_43	public class NIC_DU_SIEGE_43 extends Rubrique { final RubriqueType type = RubriqueType.NIC_DU_SIEGE_43;}
CODE_APEN_44	public class CODE_APEN_44 extends Rubrique { final RubriqueType type = RubriqueType.CODE_APEN_44;}
NUMERO__EXTENSION__NATURE_ET_LIBELLE_DE_LA_VOIE_45	public class NUMERO__EXTENSION__NATURE_ET_LIBELLE_DE_LA_VOIE_45 extends Rubrique { final RubriqueType type = RubriqueType.NUMERO__EXTENSION__NATURE_ET_LIBELLE_DE_LA_VOIE_45;}
CODE_POSTAL_46	public class CODE_POSTAL_46 extends Rubrique { final RubriqueType type = RubriqueType.CODE_POSTAL_46;}
LOCALITE_47	public class LOCALITE_47 extends Rubrique { final RubriqueType type = RubriqueType.LOCALITE_47;}
COMPLEMENT_DE_LA_LOCALISATION_DE_LA_CONSTRUCTION_48	public class COMPLEMENT_DE_LA_LOCALISATION_DE_LA_CONSTRUCTION_48 extends Rubrique { final RubriqueType type = RubriqueType.COMPLEMENT_DE_LA_LOCALISATION_DE_LA_CONSTRUCTION_48;}
SERVICE_DE_DISTRIBUTION__COMPLEMENT_DE_LOCALISATION_DE_LA_VOIE_49	public class SERVICE_DE_DISTRIBUTION__COMPLEMENT_DE_LOCALISATION_DE_LA_VOIE_49 extends Rubrique { final RubriqueType type = RubriqueType.SERVICE_DE_DISTRIBUTION__COMPLEMENT_DE_LOCALISATION_DE_LA_VOIE_49;}
EFFECTIF_MOYEN_DE_L_ENTREPRISE_AU_31_DECEMBRE_50	public class EFFECTIF_MOYEN_DE_L_ENTREPRISE_AU_31_DECEMBRE_50 extends Rubrique { final RubriqueType type = RubriqueType.EFFECTIF_MOYEN_DE_L_ENTREPRISE_AU_31_DECEMBRE_50;}
CODE_PAYS_51	public class CODE_PAYS_51 extends Rubrique { final RubriqueType type = RubriqueType.CODE_PAYS_51;}
CODE_DE_DISTRIBUTION_A_L_ETRANGER_52	public class CODE_DE_DISTRIBUTION_A_L_ETRANGER_52 extends Rubrique { final RubriqueType type = RubriqueType.CODE_DE_DISTRIBUTION_A_L_ETRANGER_52;}
NOM_ET_PRENOM_DU_CONTACT__53	public class NOM_ET_PRENOM_DU_CONTACT__53 extends Rubrique { final RubriqueType type = RubriqueType.NOM_ET_PRENOM_DU_CONTACT__53;}
ADRESSE_TELEPHONIQUE_54	public class ADRESSE_TELEPHONIQUE_54 extends Rubrique { final RubriqueType type = RubriqueType.ADRESSE_TELEPHONIQUE_54;}
ADRESSE_MEL_DU_CONTACT__55	public class ADRESSE_MEL_DU_CONTACT__55 extends Rubrique { final RubriqueType type = RubriqueType.ADRESSE_MEL_DU_CONTACT__55;}
TYPE__56	public class TYPE__56 extends Rubrique { final RubriqueType type = RubriqueType.TYPE__56;}
CODE_CAISSE__57	public class CODE_CAISSE__57 extends Rubrique { final RubriqueType type = RubriqueType.CODE_CAISSE__57;}
NIC_58	public class NIC_58 extends Rubrique { final RubriqueType type = RubriqueType.NIC_58;}
CODE_APET_59	public class CODE_APET_59 extends Rubrique { final RubriqueType type = RubriqueType.CODE_APET_59;}
NUMERO__EXTENSION__NATURE_ET_LIBELLE_DE_LA_VOIE_60	public class NUMERO__EXTENSION__NATURE_ET_LIBELLE_DE_LA_VOIE_60 extends Rubrique { final RubriqueType type = RubriqueType.NUMERO__EXTENSION__NATURE_ET_LIBELLE_DE_LA_VOIE_60;}
CODE_POSTAL_61	public class CODE_POSTAL_61 extends Rubrique { final RubriqueType type = RubriqueType.CODE_POSTAL_61;}
LOCALITE_62	public class LOCALITE_62 extends Rubrique { final RubriqueType type = RubriqueType.LOCALITE_62;}
COMPLEMENT_DE_LA_LOCALISATION_DE_LA_CONSTRUCTION_63	public class COMPLEMENT_DE_LA_LOCALISATION_DE_LA_CONSTRUCTION_63 extends Rubrique { final RubriqueType type = RubriqueType.COMPLEMENT_DE_LA_LOCALISATION_DE_LA_CONSTRUCTION_63;}
SERVICE_DE_DISTRIBUTION__COMPLEMENT_DE_LOCALISATION_DE_LA_VOIE_64	public class SERVICE_DE_DISTRIBUTION__COMPLEMENT_DE_LOCALISATION_DE_LA_VOIE_64 extends Rubrique { final RubriqueType type = RubriqueType.SERVICE_DE_DISTRIBUTION__COMPLEMENT_DE_LOCALISATION_DE_LA_VOIE_64;}
EFFECTIF_DE_FIN_DE_PERIODE_DECLAREE_DE_L_ETABLISSEMENT_65	public class EFFECTIF_DE_FIN_DE_PERIODE_DECLAREE_DE_L_ETABLISSEMENT_65 extends Rubrique { final RubriqueType type = RubriqueType.EFFECTIF_DE_FIN_DE_PERIODE_DECLAREE_DE_L_ETABLISSEMENT_65;}
TYPE_DE_REMUNERATION_SOUMISE_A_CONTRIBUTIONS_D_ASSURANCE_CHOMAGE_POUR_EXPATRIES_66	public class TYPE_DE_REMUNERATION_SOUMISE_A_CONTRIBUTIONS_D_ASSURANCE_CHOMAGE_POUR_EXPATRIES_66 extends Rubrique { final RubriqueType type = RubriqueType.TYPE_DE_REMUNERATION_SOUMISE_A_CONTRIBUTIONS_D_ASSURANCE_CHOMAGE_POUR_EXPATRIES_66;}
CODE_CATEGORIE_JURIDIQUE_67	public class CODE_CATEGORIE_JURIDIQUE_67 extends Rubrique { final RubriqueType type = RubriqueType.CODE_CATEGORIE_JURIDIQUE_67;}
CODE_PAYS_68	public class CODE_PAYS_68 extends Rubrique { final RubriqueType type = RubriqueType.CODE_PAYS_68;}
CODE_DE_DISTRIBUTION_A_L_ETRANGER_69	public class CODE_DE_DISTRIBUTION_A_L_ETRANGER_69 extends Rubrique { final RubriqueType type = RubriqueType.CODE_DE_DISTRIBUTION_A_L_ETRANGER_69;}
NATURE_JURIDIQUE_DE_L_EMPLOYEUR_70	public class NATURE_JURIDIQUE_DE_L_EMPLOYEUR_70 extends Rubrique { final RubriqueType type = RubriqueType.NATURE_JURIDIQUE_DE_L_EMPLOYEUR_70;}
REFERENCE_DU_CONTRAT_DE_PREVOYANCE_71	public class REFERENCE_DU_CONTRAT_DE_PREVOYANCE_71 extends Rubrique { final RubriqueType type = RubriqueType.REFERENCE_DU_CONTRAT_DE_PREVOYANCE_71;}
CODE_ORGANISME_DE_PREVOYANCE_72	public class CODE_ORGANISME_DE_PREVOYANCE_72 extends Rubrique { final RubriqueType type = RubriqueType.CODE_ORGANISME_DE_PREVOYANCE_72;}
CODE_DELEGATAIRE_DE_GESTION_73	public class CODE_DELEGATAIRE_DE_GESTION_73 extends Rubrique { final RubriqueType type = RubriqueType.CODE_DELEGATAIRE_DE_GESTION_73;}
PERSONNEL_COUVERT_74	public class PERSONNEL_COUVERT_74 extends Rubrique { final RubriqueType type = RubriqueType.PERSONNEL_COUVERT_74;}
IDENTIFIANT_TECHNIQUE_ADHESION__75	public class IDENTIFIANT_TECHNIQUE_ADHESION__75 extends Rubrique { final RubriqueType type = RubriqueType.IDENTIFIANT_TECHNIQUE_ADHESION__75;}
IDENTIFIANT_ORGANISME_DE_PROTECTION_SOCIALE_76	public class IDENTIFIANT_ORGANISME_DE_PROTECTION_SOCIALE_76 extends Rubrique { final RubriqueType type = RubriqueType.IDENTIFIANT_ORGANISME_DE_PROTECTION_SOCIALE_76;}
ENTITE_D_AFFECTATION_DES_OPERATIONS_77	public class ENTITE_D_AFFECTATION_DES_OPERATIONS_77 extends Rubrique { final RubriqueType type = RubriqueType.ENTITE_D_AFFECTATION_DES_OPERATIONS_77;}
BIC_78	public class BIC_78 extends Rubrique { final RubriqueType type = RubriqueType.BIC_78;}
IBAN_79	public class IBAN_79 extends Rubrique { final RubriqueType type = RubriqueType.IBAN_79;}
MONTANT_DU_VERSEMENT_80	public class MONTANT_DU_VERSEMENT_80 extends Rubrique { final RubriqueType type = RubriqueType.MONTANT_DU_VERSEMENT_80;}
DATE_DE_DEBUT_DE_PERIODE_DE_RATTACHEMENT_81	public class DATE_DE_DEBUT_DE_PERIODE_DE_RATTACHEMENT_81 extends Rubrique { final RubriqueType type = RubriqueType.DATE_DE_DEBUT_DE_PERIODE_DE_RATTACHEMENT_81;}
DATE_DE_FIN_DE_PERIODE_DE_RATTACHEMENT_82	public class DATE_DE_FIN_DE_PERIODE_DE_RATTACHEMENT_82 extends Rubrique { final RubriqueType type = RubriqueType.DATE_DE_FIN_DE_PERIODE_DE_RATTACHEMENT_82;}
CODE_DELEGATAIRE_DE_GESTION__83	public class CODE_DELEGATAIRE_DE_GESTION__83 extends Rubrique { final RubriqueType type = RubriqueType.CODE_DELEGATAIRE_DE_GESTION__83;}
MODE_DE_PAIEMENT__84	public class MODE_DE_PAIEMENT__84 extends Rubrique { final RubriqueType type = RubriqueType.MODE_DE_PAIEMENT__84;}
DATE_DE_PAIEMENT__85	public class DATE_DE_PAIEMENT__85 extends Rubrique { final RubriqueType type = RubriqueType.DATE_DE_PAIEMENT__85;}
SIRET_PAYEUR_86	public class SIRET_PAYEUR_86 extends Rubrique { final RubriqueType type = RubriqueType.SIRET_PAYEUR_86;}
IDENTIFIANT_ORGANISME_DE_PROTECTION_SOCIALE_87	public class IDENTIFIANT_ORGANISME_DE_PROTECTION_SOCIALE_87 extends Rubrique { final RubriqueType type = RubriqueType.IDENTIFIANT_ORGANISME_DE_PROTECTION_SOCIALE_87;}
ENTITE_D_AFFECTATION_DES_OPERATIONS_88	public class ENTITE_D_AFFECTATION_DES_OPERATIONS_88 extends Rubrique { final RubriqueType type = RubriqueType.ENTITE_D_AFFECTATION_DES_OPERATIONS_88;}
DATE_DE_DEBUT_DE_PERIODE_DE_RATTACHEMENT_89	public class DATE_DE_DEBUT_DE_PERIODE_DE_RATTACHEMENT_89 extends Rubrique { final RubriqueType type = RubriqueType.DATE_DE_DEBUT_DE_PERIODE_DE_RATTACHEMENT_89;}
DATE_DE_FIN_DE_PERIODE_DE_RATTACHEMENT_90	public class DATE_DE_FIN_DE_PERIODE_DE_RATTACHEMENT_90 extends Rubrique { final RubriqueType type = RubriqueType.DATE_DE_FIN_DE_PERIODE_DE_RATTACHEMENT_90;}
MONTANT_TOTAL_DE_COTISATIONS_91	public class MONTANT_TOTAL_DE_COTISATIONS_91 extends Rubrique { final RubriqueType type = RubriqueType.MONTANT_TOTAL_DE_COTISATIONS_91;}
CODE_DE_COTISATION_92	public class CODE_DE_COTISATION_92 extends Rubrique { final RubriqueType type = RubriqueType.CODE_DE_COTISATION_92;}
QUALIFIANT_D_ASSIETTE_93	public class QUALIFIANT_D_ASSIETTE_93 extends Rubrique { final RubriqueType type = RubriqueType.QUALIFIANT_D_ASSIETTE_93;}
TAUX_DE_COTISATION_94	public class TAUX_DE_COTISATION_94 extends Rubrique { final RubriqueType type = RubriqueType.TAUX_DE_COTISATION_94;}
MONTANT_D_ASSIETTE_95	public class MONTANT_D_ASSIETTE_95 extends Rubrique { final RubriqueType type = RubriqueType.MONTANT_D_ASSIETTE_95;}
MONTANT_DE_COTISATION_96	public class MONTANT_DE_COTISATION_96 extends Rubrique { final RubriqueType type = RubriqueType.MONTANT_DE_COTISATION_96;}
CODE_INSEE_COMMUNE_97	public class CODE_INSEE_COMMUNE_97 extends Rubrique { final RubriqueType type = RubriqueType.CODE_INSEE_COMMUNE_97;}
NUMERO_D_INSCRIPTION_AU_REPERTOIRE_98	public class NUMERO_D_INSCRIPTION_AU_REPERTOIRE_98 extends Rubrique { final RubriqueType type = RubriqueType.NUMERO_D_INSCRIPTION_AU_REPERTOIRE_98;}
NOM_DE_FAMILLE_99	public class NOM_DE_FAMILLE_99 extends Rubrique { final RubriqueType type = RubriqueType.NOM_DE_FAMILLE_99;}
NOM_D_USAGE_100	public class NOM_D_USAGE_100 extends Rubrique { final RubriqueType type = RubriqueType.NOM_D_USAGE_100;}
PRENOMS_101	public class PRENOMS_101 extends Rubrique { final RubriqueType type = RubriqueType.PRENOMS_101;}
SEXE_102	public class SEXE_102 extends Rubrique { final RubriqueType type = RubriqueType.SEXE_102;}
DATE_DE_NAISSANCE_103	public class DATE_DE_NAISSANCE_103 extends Rubrique { final RubriqueType type = RubriqueType.DATE_DE_NAISSANCE_103;}
LIEU_DE_NAISSANCE_104	public class LIEU_DE_NAISSANCE_104 extends Rubrique { final RubriqueType type = RubriqueType.LIEU_DE_NAISSANCE_104;}
NUMERO__EXTENSION__NATURE_ET_LIBELLE_DE_LA_VOIE_105	public class NUMERO__EXTENSION__NATURE_ET_LIBELLE_DE_LA_VOIE_105 extends Rubrique { final RubriqueType type = RubriqueType.NUMERO__EXTENSION__NATURE_ET_LIBELLE_DE_LA_VOIE_105;}
CODE_POSTAL_106	public class CODE_POSTAL_106 extends Rubrique { final RubriqueType type = RubriqueType.CODE_POSTAL_106;}
LOCALITE_107	public class LOCALITE_107 extends Rubrique { final RubriqueType type = RubriqueType.LOCALITE_107;}
CODE_PAYS_108	public class CODE_PAYS_108 extends Rubrique { final RubriqueType type = RubriqueType.CODE_PAYS_108;}
CODE_DE_DISTRIBUTION_A_L_ETRANGER_109	public class CODE_DE_DISTRIBUTION_A_L_ETRANGER_109 extends Rubrique { final RubriqueType type = RubriqueType.CODE_DE_DISTRIBUTION_A_L_ETRANGER_109;}
CODIFICATION_UE_110	public class CODIFICATION_UE_110 extends Rubrique { final RubriqueType type = RubriqueType.CODIFICATION_UE_110;}
CODE_DEPARTEMENT_DE_NAISSANCE_111	public class CODE_DEPARTEMENT_DE_NAISSANCE_111 extends Rubrique { final RubriqueType type = RubriqueType.CODE_DEPARTEMENT_DE_NAISSANCE_111;}
CODE_PAYS_DE_NAISSANCE_112	public class CODE_PAYS_DE_NAISSANCE_112 extends Rubrique { final RubriqueType type = RubriqueType.CODE_PAYS_DE_NAISSANCE_112;}
COMPLEMENT_DE_LA_LOCALISATION_DE_LA_CONSTRUCTION_113	public class COMPLEMENT_DE_LA_LOCALISATION_DE_LA_CONSTRUCTION_113 extends Rubrique { final RubriqueType type = RubriqueType.COMPLEMENT_DE_LA_LOCALISATION_DE_LA_CONSTRUCTION_113;}
SERVICE_DE_DISTRIBUTION__COMPLEMENT_DE_LOCALISATION_DE_LA_VOIE_114	public class SERVICE_DE_DISTRIBUTION__COMPLEMENT_DE_LOCALISATION_DE_LA_VOIE_114 extends Rubrique { final RubriqueType type = RubriqueType.SERVICE_DE_DISTRIBUTION__COMPLEMENT_DE_LOCALISATION_DE_LA_VOIE_114;}
ADRESSE_MEL_115	public class ADRESSE_MEL_115 extends Rubrique { final RubriqueType type = RubriqueType.ADRESSE_MEL_115;}
MATRICULE_DE_L_INDIVIDU_DANS_L_ENTREPRISE_116	public class MATRICULE_DE_L_INDIVIDU_DANS_L_ENTREPRISE_116 extends Rubrique { final RubriqueType type = RubriqueType.MATRICULE_DE_L_INDIVIDU_DANS_L_ENTREPRISE_116;}
NUMERO_TECHNIQUE_TEMPORAIRE_117	public class NUMERO_TECHNIQUE_TEMPORAIRE_117 extends Rubrique { final RubriqueType type = RubriqueType.NUMERO_TECHNIQUE_TEMPORAIRE_117;}
NOMBRE_D_ENFANTS_A_CHARGE__118	public class NOMBRE_D_ENFANTS_A_CHARGE__118 extends Rubrique { final RubriqueType type = RubriqueType.NOMBRE_D_ENFANTS_A_CHARGE__118;}
STATUT_A_L_ETRANGER_AU_SENS_FISCAL__119	public class STATUT_A_L_ETRANGER_AU_SENS_FISCAL__119 extends Rubrique { final RubriqueType type = RubriqueType.STATUT_A_L_ETRANGER_AU_SENS_FISCAL__119;}
EMBAUCHE__120	public class EMBAUCHE__120 extends Rubrique { final RubriqueType type = RubriqueType.EMBAUCHE__120;}
DATE_DE_LA_MODIFICATION_121	public class DATE_DE_LA_MODIFICATION_121 extends Rubrique { final RubriqueType type = RubriqueType.DATE_DE_LA_MODIFICATION_121;}
ANCIEN_NIR_122	public class ANCIEN_NIR_122 extends Rubrique { final RubriqueType type = RubriqueType.ANCIEN_NIR_122;}
ANCIEN_NOM_DE_FAMILLE_123	public class ANCIEN_NOM_DE_FAMILLE_123 extends Rubrique { final RubriqueType type = RubriqueType.ANCIEN_NOM_DE_FAMILLE_123;}
ANCIENS_PRENOMS_124	public class ANCIENS_PRENOMS_124 extends Rubrique { final RubriqueType type = RubriqueType.ANCIENS_PRENOMS_124;}
ANCIENNE_DATE_DE_NAISSANCE_125	public class ANCIENNE_DATE_DE_NAISSANCE_125 extends Rubrique { final RubriqueType type = RubriqueType.ANCIENNE_DATE_DE_NAISSANCE_125;}
DATE_DE_DEBUT_DU_CONTRAT_126	public class DATE_DE_DEBUT_DU_CONTRAT_126 extends Rubrique { final RubriqueType type = RubriqueType.DATE_DE_DEBUT_DU_CONTRAT_126;}
STATUT_DU_SALARIE_(CONVENTIONNEL)_127	public class STATUT_DU_SALARIE_(CONVENTIONNEL)_127 extends Rubrique { final RubriqueType type = RubriqueType.STATUT_DU_SALARIE_(CONVENTIONNEL)_127;}
CODE_STATUT_CATEGORIEL_RETRAITE_COMPLEMENTAIRE_OBLIGATOIRE_128	public class CODE_STATUT_CATEGORIEL_RETRAITE_COMPLEMENTAIRE_OBLIGATOIRE_128 extends Rubrique { final RubriqueType type = RubriqueType.CODE_STATUT_CATEGORIEL_RETRAITE_COMPLEMENTAIRE_OBLIGATOIRE_128;}
CODE_PROFESSION_ET_CATEGORIE_SOCIOPROFESSIONNELLE_(PCS_129	public class CODE_PROFESSION_ET_CATEGORIE_SOCIOPROFESSIONNELLE_(PCS_129 extends Rubrique { final RubriqueType type = RubriqueType.CODE_PROFESSION_ET_CATEGORIE_SOCIOPROFESSIONNELLE_(PCS_129;}
CODE_COMPLEMENT_PCS_130	public class CODE_COMPLEMENT_PCS_130 extends Rubrique { final RubriqueType type = RubriqueType.CODE_COMPLEMENT_PCS_130;}
LIBELLE_DE_L_EMPLOI_131	public class LIBELLE_DE_L_EMPLOI_131 extends Rubrique { final RubriqueType type = RubriqueType.LIBELLE_DE_L_EMPLOI_131;}
NATURE_DU_CONTRAT_132	public class NATURE_DU_CONTRAT_132 extends Rubrique { final RubriqueType type = RubriqueType.NATURE_DU_CONTRAT_132;}
DISPOSITIF_DE_POLITIQUE_PUBLIQUE_133	public class DISPOSITIF_DE_POLITIQUE_PUBLIQUE_133 extends Rubrique { final RubriqueType type = RubriqueType.DISPOSITIF_DE_POLITIQUE_PUBLIQUE_133;}
NUMERO_DU_CONTRAT_134	public class NUMERO_DU_CONTRAT_134 extends Rubrique { final RubriqueType type = RubriqueType.NUMERO_DU_CONTRAT_134;}
DATE_DE_FIN_PREVISIONNELLE_DU_CONTRAT_135	public class DATE_DE_FIN_PREVISIONNELLE_DU_CONTRAT_135 extends Rubrique { final RubriqueType type = RubriqueType.DATE_DE_FIN_PREVISIONNELLE_DU_CONTRAT_135;}
UNITE_DE_MESURE_DE_LA_QUOTITE_DE_TRAVAIL_136	public class UNITE_DE_MESURE_DE_LA_QUOTITE_DE_TRAVAIL_136 extends Rubrique { final RubriqueType type = RubriqueType.UNITE_DE_MESURE_DE_LA_QUOTITE_DE_TRAVAIL_136;}
QUOTITE_DE_TRAVAIL_DE_REFERENCE_DE_L_ENTREPRISE_POUR_LA_CATEGORIE_DE_SALARIE_137	public class QUOTITE_DE_TRAVAIL_DE_REFERENCE_DE_L_ENTREPRISE_POUR_LA_CATEGORIE_DE_SALARIE_137 extends Rubrique { final RubriqueType type = RubriqueType.QUOTITE_DE_TRAVAIL_DE_REFERENCE_DE_L_ENTREPRISE_POUR_LA_CATEGORIE_DE_SALARIE_137;}
QUOTITE_DE_TRAVAIL_DU_CONTRAT_138	public class QUOTITE_DE_TRAVAIL_DU_CONTRAT_138 extends Rubrique { final RubriqueType type = RubriqueType.QUOTITE_DE_TRAVAIL_DU_CONTRAT_138;}
MODALITE_D_EXERCICE_DU_TEMPS_DE_TRAVAIL_139	public class MODALITE_D_EXERCICE_DU_TEMPS_DE_TRAVAIL_139 extends Rubrique { final RubriqueType type = RubriqueType.MODALITE_D_EXERCICE_DU_TEMPS_DE_TRAVAIL_139;}
SALAIRE_DE_REFERENCE_PORTE_PAR_LE_CONTRAT_140	public class SALAIRE_DE_REFERENCE_PORTE_PAR_LE_CONTRAT_140 extends Rubrique { final RubriqueType type = RubriqueType.SALAIRE_DE_REFERENCE_PORTE_PAR_LE_CONTRAT_140;}
REGIME_LOCAL_ALSACE_MOSELLE_141	public class REGIME_LOCAL_ALSACE_MOSELLE_141 extends Rubrique { final RubriqueType type = RubriqueType.REGIME_LOCAL_ALSACE_MOSELLE_141;}
CODE_CONVENTION_COLLECTIVE_APPLICABLE_142	public class CODE_CONVENTION_COLLECTIVE_APPLICABLE_142 extends Rubrique { final RubriqueType type = RubriqueType.CODE_CONVENTION_COLLECTIVE_APPLICABLE_142;}
CODE_REGIME_DE_BASE_RISQUE_MALADIE_143	public class CODE_REGIME_DE_BASE_RISQUE_MALADIE_143 extends Rubrique { final RubriqueType type = RubriqueType.CODE_REGIME_DE_BASE_RISQUE_MALADIE_143;}
IDENTIFIANT_DU_LIEU_DE_TRAVAIL_144	public class IDENTIFIANT_DU_LIEU_DE_TRAVAIL_144 extends Rubrique { final RubriqueType type = RubriqueType.IDENTIFIANT_DU_LIEU_DE_TRAVAIL_144;}
CODE_REGIME_DE_BASE_RISQUE_VIEILLESSE_145	public class CODE_REGIME_DE_BASE_RISQUE_VIEILLESSE_145 extends Rubrique { final RubriqueType type = RubriqueType.CODE_REGIME_DE_BASE_RISQUE_VIEILLESSE_145;}
MOTIF_DE_RECOURS_146	public class MOTIF_DE_RECOURS_146 extends Rubrique { final RubriqueType type = RubriqueType.MOTIF_DE_RECOURS_146;}
CODE_CAISSE_PROFESSIONNELLE_DE_CONGES_PAYES_147	public class CODE_CAISSE_PROFESSIONNELLE_DE_CONGES_PAYES_147 extends Rubrique { final RubriqueType type = RubriqueType.CODE_CAISSE_PROFESSIONNELLE_DE_CONGES_PAYES_147;}
TAUX_DE_DEDUCTION_FORFAITAIRE_SPECIFIQUE_POUR_FRAIS_PROFESSIONNELS_148	public class TAUX_DE_DEDUCTION_FORFAITAIRE_SPECIFIQUE_POUR_FRAIS_PROFESSIONNELS_148 extends Rubrique { final RubriqueType type = RubriqueType.TAUX_DE_DEDUCTION_FORFAITAIRE_SPECIFIQUE_POUR_FRAIS_PROFESSIONNELS_148;}
DETACHE_EXPATRIE_149	public class DETACHE_EXPATRIE_149 extends Rubrique { final RubriqueType type = RubriqueType.DETACHE_EXPATRIE_149;}
MOTIF_D_EXCLUSION_DSN_150	public class MOTIF_D_EXCLUSION_DSN_150 extends Rubrique { final RubriqueType type = RubriqueType.MOTIF_D_EXCLUSION_DSN_150;}
STATUT_D_EMPLOI_DU_SALARIE_151	public class STATUT_D_EMPLOI_DU_SALARIE_151 extends Rubrique { final RubriqueType type = RubriqueType.STATUT_D_EMPLOI_DU_SALARIE_151;}
CODE_AFFECTATION_ASSURANCE_CHOMAGE_152	public class CODE_AFFECTATION_ASSURANCE_CHOMAGE_152 extends Rubrique { final RubriqueType type = RubriqueType.CODE_AFFECTATION_ASSURANCE_CHOMAGE_152;}
NUMERO_INTERNE_EMPLOYEUR_PUBLIC_153	public class NUMERO_INTERNE_EMPLOYEUR_PUBLIC_153 extends Rubrique { final RubriqueType type = RubriqueType.NUMERO_INTERNE_EMPLOYEUR_PUBLIC_153;}
TYPE_DE_GESTION_DE_L’ASSURANCE_CHOMAGE_154	public class TYPE_DE_GESTION_DE_L’ASSURANCE_CHOMAGE_154 extends Rubrique { final RubriqueType type = RubriqueType.TYPE_DE_GESTION_DE_L’ASSURANCE_CHOMAGE_154;}
DATE_D_ADHESION_155	public class DATE_D_ADHESION_155 extends Rubrique { final RubriqueType type = RubriqueType.DATE_D_ADHESION_155;}
DATE_DE_DENONCIATION_156	public class DATE_DE_DENONCIATION_156 extends Rubrique { final RubriqueType type = RubriqueType.DATE_DE_DENONCIATION_156;}
DATE_D_EFFET_DE_LA_CONVENTION_DE_GESTION_157	public class DATE_D_EFFET_DE_LA_CONVENTION_DE_GESTION_157 extends Rubrique { final RubriqueType type = RubriqueType.DATE_D_EFFET_DE_LA_CONVENTION_DE_GESTION_157;}
NUMERO_DE_CONVENTION_DE_GESTION_158	public class NUMERO_DE_CONVENTION_DE_GESTION_158 extends Rubrique { final RubriqueType type = RubriqueType.NUMERO_DE_CONVENTION_DE_GESTION_158;}
CODE_DELEGATAIRE_DU_RISQUE_MALADIE__159	public class CODE_DELEGATAIRE_DU_RISQUE_MALADIE__159 extends Rubrique { final RubriqueType type = RubriqueType.CODE_DELEGATAIRE_DU_RISQUE_MALADIE__159;}
CODE_EMPLOIS_MULTIPLES__160	public class CODE_EMPLOIS_MULTIPLES__160 extends Rubrique { final RubriqueType type = RubriqueType.CODE_EMPLOIS_MULTIPLES__160;}
CODE_EMPLOYEURS_MULTIPLES__161	public class CODE_EMPLOYEURS_MULTIPLES__161 extends Rubrique { final RubriqueType type = RubriqueType.CODE_EMPLOYEURS_MULTIPLES__161;}
CODE_METIER__162	public class CODE_METIER__162 extends Rubrique { final RubriqueType type = RubriqueType.CODE_METIER__162;}
CODE_REGIME_DE_BASE_RISQUE_ACCIDENT_DU_TRAVAIL__163	public class CODE_REGIME_DE_BASE_RISQUE_ACCIDENT_DU_TRAVAIL__163 extends Rubrique { final RubriqueType type = RubriqueType.CODE_REGIME_DE_BASE_RISQUE_ACCIDENT_DU_TRAVAIL__163;}
CODE_RISQUE_ACCIDENT_DU_TRAVAIL__164	public class CODE_RISQUE_ACCIDENT_DU_TRAVAIL__164 extends Rubrique { final RubriqueType type = RubriqueType.CODE_RISQUE_ACCIDENT_DU_TRAVAIL__164;}
POSITIONNEMENT_DANS_LA_CONVENTION_COLLECTIVE__165	public class POSITIONNEMENT_DANS_LA_CONVENTION_COLLECTIVE__165 extends Rubrique { final RubriqueType type = RubriqueType.POSITIONNEMENT_DANS_LA_CONVENTION_COLLECTIVE__165;}
CODE_STATUT_CATEGORIEL_APECITA__166	public class CODE_STATUT_CATEGORIEL_APECITA__166 extends Rubrique { final RubriqueType type = RubriqueType.CODE_STATUT_CATEGORIEL_APECITA__166;}
TAUX_DE_COTISATION_ACCIDENT_DU_TRAVAIL__167	public class TAUX_DE_COTISATION_ACCIDENT_DU_TRAVAIL__167 extends Rubrique { final RubriqueType type = RubriqueType.TAUX_DE_COTISATION_ACCIDENT_DU_TRAVAIL__167;}
SALARIE_A_TEMPS_PARTIEL_COTISANT_A_TEMPS_PLEIN__168	public class SALARIE_A_TEMPS_PARTIEL_COTISANT_A_TEMPS_PLEIN__168 extends Rubrique { final RubriqueType type = RubriqueType.SALARIE_A_TEMPS_PARTIEL_COTISANT_A_TEMPS_PLEIN__168;}
REMUNERATION_AU_POURBOIRE__169	public class REMUNERATION_AU_POURBOIRE__169 extends Rubrique { final RubriqueType type = RubriqueType.REMUNERATION_AU_POURBOIRE__169;}
IDENTIFIANT_DE_L’ETABLISSEMENT_UTILISATEUR__170	public class IDENTIFIANT_DE_L’ETABLISSEMENT_UTILISATEUR__170 extends Rubrique { final RubriqueType type = RubriqueType.IDENTIFIANT_DE_L’ETABLISSEMENT_UTILISATEUR__170;}
NUMERO_DE_CERTIFICATION_SOCIALE__171	public class NUMERO_DE_CERTIFICATION_SOCIALE__171 extends Rubrique { final RubriqueType type = RubriqueType.NUMERO_DE_CERTIFICATION_SOCIALE__171;}
NUMERO_DE_LABEL_«_PRESTATAIRE_DE_SERVICES_DU_SPECTACLE_VIVANT_»__172	public class NUMERO_DE_LABEL_«_PRESTATAIRE_DE_SERVICES_DU_SPECTACLE_VIVANT_»__172 extends Rubrique { final RubriqueType type = RubriqueType.NUMERO_DE_LABEL_«_PRESTATAIRE_DE_SERVICES_DU_SPECTACLE_VIVANT_»__172;}
NUMERO_DE_LICENCE_ENTREPRENEUR_SPECTACLE__173	public class NUMERO_DE_LICENCE_ENTREPRENEUR_SPECTACLE__173 extends Rubrique { final RubriqueType type = RubriqueType.NUMERO_DE_LICENCE_ENTREPRENEUR_SPECTACLE__173;}
NUMERO_OBJET_SPECTACLE__174	public class NUMERO_OBJET_SPECTACLE__174 extends Rubrique { final RubriqueType type = RubriqueType.NUMERO_OBJET_SPECTACLE__174;}
STATUT_ORGANISATEUR_SPECTACLE__175	public class STATUT_ORGANISATEUR_SPECTACLE__175 extends Rubrique { final RubriqueType type = RubriqueType.STATUT_ORGANISATEUR_SPECTACLE__175;}
DATE_DE_LA_MODIFICATION_176	public class DATE_DE_LA_MODIFICATION_176 extends Rubrique { final RubriqueType type = RubriqueType.DATE_DE_LA_MODIFICATION_176;}
ANCIEN_STATUT_DU_SALARIE_CONVENTIONNEL_177	public class ANCIEN_STATUT_DU_SALARIE_CONVENTIONNEL_177 extends Rubrique { final RubriqueType type = RubriqueType.ANCIEN_STATUT_DU_SALARIE_CONVENTIONNEL_177;}
ANCIEN_CODE_STATUT_CATEGORIEL_RETRAITE_COMPLEMENTAIRE_OBLIGATOIRE_178	public class ANCIEN_CODE_STATUT_CATEGORIEL_RETRAITE_COMPLEMENTAIRE_OBLIGATOIRE_178 extends Rubrique { final RubriqueType type = RubriqueType.ANCIEN_CODE_STATUT_CATEGORIEL_RETRAITE_COMPLEMENTAIRE_OBLIGATOIRE_178;}
ANCIENNE_NATURE_DU_CONTRAT_179	public class ANCIENNE_NATURE_DU_CONTRAT_179 extends Rubrique { final RubriqueType type = RubriqueType.ANCIENNE_NATURE_DU_CONTRAT_179;}
ANCIEN_DISPOSITIF_DE_POLITIQUE_PUBLIQUE_180	public class ANCIEN_DISPOSITIF_DE_POLITIQUE_PUBLIQUE_180 extends Rubrique { final RubriqueType type = RubriqueType.ANCIEN_DISPOSITIF_DE_POLITIQUE_PUBLIQUE_180;}
ANCIENNE_UNITE_DE_MESURE_DE_LA_QUOTITE_DE_TRAVAIL_181	public class ANCIENNE_UNITE_DE_MESURE_DE_LA_QUOTITE_DE_TRAVAIL_181 extends Rubrique { final RubriqueType type = RubriqueType.ANCIENNE_UNITE_DE_MESURE_DE_LA_QUOTITE_DE_TRAVAIL_181;}
ANCIENNE_QUOTITE_DE_TRAVAIL_DU_CONTRAT_182	public class ANCIENNE_QUOTITE_DE_TRAVAIL_DU_CONTRAT_182 extends Rubrique { final RubriqueType type = RubriqueType.ANCIENNE_QUOTITE_DE_TRAVAIL_DU_CONTRAT_182;}
ANCIENNE_MODALITE_D_EXERCICE_DU_TEMPS_DE_TRAVAIL_183	public class ANCIENNE_MODALITE_D_EXERCICE_DU_TEMPS_DE_TRAVAIL_183 extends Rubrique { final RubriqueType type = RubriqueType.ANCIENNE_MODALITE_D_EXERCICE_DU_TEMPS_DE_TRAVAIL_183;}
ANCIEN_SALAIRE_DE_REFERENCE_PORTE_PAR_LE_CONTRAT_184	public class ANCIEN_SALAIRE_DE_REFERENCE_PORTE_PAR_LE_CONTRAT_184 extends Rubrique { final RubriqueType type = RubriqueType.ANCIEN_SALAIRE_DE_REFERENCE_PORTE_PAR_LE_CONTRAT_184;}
ANCIEN_REGIME_LOCAL_ALSACE_MOSELLE_185	public class ANCIEN_REGIME_LOCAL_ALSACE_MOSELLE_185 extends Rubrique { final RubriqueType type = RubriqueType.ANCIEN_REGIME_LOCAL_ALSACE_MOSELLE_185;}
ANCIEN_CODE_CONVENTION_COLLECTIVE_APPLICABLE_186	public class ANCIEN_CODE_CONVENTION_COLLECTIVE_APPLICABLE_186 extends Rubrique { final RubriqueType type = RubriqueType.ANCIEN_CODE_CONVENTION_COLLECTIVE_APPLICABLE_186;}
SIRET_ANCIEN_ETABLISSEMENT_D_AFFECTATION_187	public class SIRET_ANCIEN_ETABLISSEMENT_D_AFFECTATION_187 extends Rubrique { final RubriqueType type = RubriqueType.SIRET_ANCIEN_ETABLISSEMENT_D_AFFECTATION_187;}
ANCIEN_IDENTIFIANT_DU_LIEU_DE_TRAVAIL_188	public class ANCIEN_IDENTIFIANT_DU_LIEU_DE_TRAVAIL_188 extends Rubrique { final RubriqueType type = RubriqueType.ANCIEN_IDENTIFIANT_DU_LIEU_DE_TRAVAIL_188;}
ANCIEN_NUMERO_DU_CONTRAT_189	public class ANCIEN_NUMERO_DU_CONTRAT_189 extends Rubrique { final RubriqueType type = RubriqueType.ANCIEN_NUMERO_DU_CONTRAT_189;}
ANCIEN_MOTIF_DE_RECOURS_190	public class ANCIEN_MOTIF_DE_RECOURS_190 extends Rubrique { final RubriqueType type = RubriqueType.ANCIEN_MOTIF_DE_RECOURS_190;}
ANCIEN_TAUX_DE_DEDUCTION_FORFAITAIRE_SPECIFIQUE_POUR_FRAIS_PROFESSIONNELS_191	public class ANCIEN_TAUX_DE_DEDUCTION_FORFAITAIRE_SPECIFIQUE_POUR_FRAIS_PROFESSIONNELS_191 extends Rubrique { final RubriqueType type = RubriqueType.ANCIEN_TAUX_DE_DEDUCTION_FORFAITAIRE_SPECIFIQUE_POUR_FRAIS_PROFESSIONNELS_191;}
ANCIEN_DETACHE_EXPATRIE_192	public class ANCIEN_DETACHE_EXPATRIE_192 extends Rubrique { final RubriqueType type = RubriqueType.ANCIEN_DETACHE_EXPATRIE_192;}
ANCIEN_CODE_PROFESSION_ET_CATEGORIE_SOCIOPROFESSIONNELLE_193	public class ANCIEN_CODE_PROFESSION_ET_CATEGORIE_SOCIOPROFESSIONNELLE_193 extends Rubrique { final RubriqueType type = RubriqueType.ANCIEN_CODE_PROFESSION_ET_CATEGORIE_SOCIOPROFESSIONNELLE_193;}
ANCIEN_CODE_COMPLEMENT_PCS_194	public class ANCIEN_CODE_COMPLEMENT_PCS_194 extends Rubrique { final RubriqueType type = RubriqueType.ANCIEN_CODE_COMPLEMENT_PCS_194;}
ANCIENNE_DATE_DE_DEBUT_DU_CONTRAT_195	public class ANCIENNE_DATE_DE_DEBUT_DU_CONTRAT_195 extends Rubrique { final RubriqueType type = RubriqueType.ANCIENNE_DATE_DE_DEBUT_DU_CONTRAT_195;}
ANCIENNE_QUOTITE_DE_TRAVAIL_DE_REFERENCE_DE_L_ENTREPRISE_POUR_LA_CATEGORIE_DE_SALARIE_196	public class ANCIENNE_QUOTITE_DE_TRAVAIL_DE_REFERENCE_DE_L_ENTREPRISE_POUR_LA_CATEGORIE_DE_SALARIE_196 extends Rubrique { final RubriqueType type = RubriqueType.ANCIENNE_QUOTITE_DE_TRAVAIL_DE_REFERENCE_DE_L_ENTREPRISE_POUR_LA_CATEGORIE_DE_SALARIE_196;}
ANCIEN_CODE_CAISSE_PROFESSIONNELLE_DE_CONGES_PAYES_197	public class ANCIEN_CODE_CAISSE_PROFESSIONNELLE_DE_CONGES_PAYES_197 extends Rubrique { final RubriqueType type = RubriqueType.ANCIEN_CODE_CAISSE_PROFESSIONNELLE_DE_CONGES_PAYES_197;}
ANCIEN_CODE_RISQUE_ACCIDENT_DU_TRAVAIL__198	public class ANCIEN_CODE_RISQUE_ACCIDENT_DU_TRAVAIL__198 extends Rubrique { final RubriqueType type = RubriqueType.ANCIEN_CODE_RISQUE_ACCIDENT_DU_TRAVAIL__198;}
ANCIEN_CODE_STATUT_CATEGORIEL_APECITA__199	public class ANCIEN_CODE_STATUT_CATEGORIEL_APECITA__199 extends Rubrique { final RubriqueType type = RubriqueType.ANCIEN_CODE_STATUT_CATEGORIEL_APECITA__199;}
ANCIEN_SALARIE_A_TEMPS_PARTIEL_COTISANT_A_TEMPS_PLEIN__200	public class ANCIEN_SALARIE_A_TEMPS_PARTIEL_COTISANT_A_TEMPS_PLEIN__200 extends Rubrique { final RubriqueType type = RubriqueType.ANCIEN_SALARIE_A_TEMPS_PARTIEL_COTISANT_A_TEMPS_PLEIN__200;}
PROFONDEUR_DE_RECALCUL_DE_LA_PAIE__201	public class PROFONDEUR_DE_RECALCUL_DE_LA_PAIE__201 extends Rubrique { final RubriqueType type = RubriqueType.PROFONDEUR_DE_RECALCUL_DE_LA_PAIE__201;}
DATE_DE_VERSEMENT_202	public class DATE_DE_VERSEMENT_202 extends Rubrique { final RubriqueType type = RubriqueType.DATE_DE_VERSEMENT_202;}
REMUNERATION_NETTE_FISCALE_203	public class REMUNERATION_NETTE_FISCALE_203 extends Rubrique { final RubriqueType type = RubriqueType.REMUNERATION_NETTE_FISCALE_203;}
NUMERO_DE_VERSEMENT_204	public class NUMERO_DE_VERSEMENT_204 extends Rubrique { final RubriqueType type = RubriqueType.NUMERO_DE_VERSEMENT_204;}
MONTANT_NET_VERSE_205	public class MONTANT_NET_VERSE_205 extends Rubrique { final RubriqueType type = RubriqueType.MONTANT_NET_VERSE_205;}
DATE_DE_DEBUT_DE_PERIODE_DE_PAIE_206	public class DATE_DE_DEBUT_DE_PERIODE_DE_PAIE_206 extends Rubrique { final RubriqueType type = RubriqueType.DATE_DE_DEBUT_DE_PERIODE_DE_PAIE_206;}
DATE_DE_FIN_DE_PERIODE_DE_PAIE_207	public class DATE_DE_FIN_DE_PERIODE_DE_PAIE_207 extends Rubrique { final RubriqueType type = RubriqueType.DATE_DE_FIN_DE_PERIODE_DE_PAIE_207;}
DATE_DE_DEBUT_DE_CONTRAT_208	public class DATE_DE_DEBUT_DE_CONTRAT_208 extends Rubrique { final RubriqueType type = RubriqueType.DATE_DE_DEBUT_DE_CONTRAT_208;}
NUMERO_DU_CONTRAT_209	public class NUMERO_DU_CONTRAT_209 extends Rubrique { final RubriqueType type = RubriqueType.NUMERO_DU_CONTRAT_209;}
TYPE_210	public class TYPE_210 extends Rubrique { final RubriqueType type = RubriqueType.TYPE_210;}
NOMBRE_D_HEURE_SUPPLEMENTAIRE_OU_COMPLEMENTAIRE__D_EQUIVALENCE__D_HABILLAGE_ET_DE_DESHABILLAGE_211	public class NOMBRE_D_HEURE_SUPPLEMENTAIRE_OU_COMPLEMENTAIRE__D_EQUIVALENCE__D_HABILLAGE_ET_DE_DESHABILLAGE_211 extends Rubrique { final RubriqueType type = RubriqueType.NOMBRE_D_HEURE_SUPPLEMENTAIRE_OU_COMPLEMENTAIRE__D_EQUIVALENCE__D_HABILLAGE_ET_DE_DESHABILLAGE_211;}
MONTANT_212	public class MONTANT_212 extends Rubrique { final RubriqueType type = RubriqueType.MONTANT_212;}
TYPE_213	public class TYPE_213 extends Rubrique { final RubriqueType type = RubriqueType.TYPE_213;}
MONTANT_214	public class MONTANT_214 extends Rubrique { final RubriqueType type = RubriqueType.MONTANT_214;}
DATE_DE_DEBUT_DE_LA_PERIODE_DE_RATTACHEMENT_215	public class DATE_DE_DEBUT_DE_LA_PERIODE_DE_RATTACHEMENT_215 extends Rubrique { final RubriqueType type = RubriqueType.DATE_DE_DEBUT_DE_LA_PERIODE_DE_RATTACHEMENT_215;}
DATE_DE_FIN_DE_LA_PERIODE_DE_RATTACHEMENT_216	public class DATE_DE_FIN_DE_LA_PERIODE_DE_RATTACHEMENT_216 extends Rubrique { final RubriqueType type = RubriqueType.DATE_DE_FIN_DE_LA_PERIODE_DE_RATTACHEMENT_216;}
DATE_DE_DEBUT_DE_CONTRAT_217	public class DATE_DE_DEBUT_DE_CONTRAT_217 extends Rubrique { final RubriqueType type = RubriqueType.DATE_DE_DEBUT_DE_CONTRAT_217;}
NUMERO_DU_CONTRAT_218	public class NUMERO_DU_CONTRAT_218 extends Rubrique { final RubriqueType type = RubriqueType.NUMERO_DU_CONTRAT_218;}
TYPE_219	public class TYPE_219 extends Rubrique { final RubriqueType type = RubriqueType.TYPE_219;}
MESURE_220	public class MESURE_220 extends Rubrique { final RubriqueType type = RubriqueType.MESURE_220;}
UNITE_DE_MESURE_221	public class UNITE_DE_MESURE_221 extends Rubrique { final RubriqueType type = RubriqueType.UNITE_DE_MESURE_221;}
TYPE_222	public class TYPE_222 extends Rubrique { final RubriqueType type = RubriqueType.TYPE_222;}
MONTANT_223	public class MONTANT_223 extends Rubrique { final RubriqueType type = RubriqueType.MONTANT_223;}
DATE_DE_DEBUT_DE_PERIODE_DE_RATTACHEMENT_224	public class DATE_DE_DEBUT_DE_PERIODE_DE_RATTACHEMENT_224 extends Rubrique { final RubriqueType type = RubriqueType.DATE_DE_DEBUT_DE_PERIODE_DE_RATTACHEMENT_224;}
DATE_DE_FIN_DE_PERIODE_DE_RATTACHEMENT_225	public class DATE_DE_FIN_DE_PERIODE_DE_RATTACHEMENT_225 extends Rubrique { final RubriqueType type = RubriqueType.DATE_DE_FIN_DE_PERIODE_DE_RATTACHEMENT_225;}
MONTANT_VERSE__226	public class MONTANT_VERSE__226 extends Rubrique { final RubriqueType type = RubriqueType.MONTANT_VERSE__226;}
TYPE_DE_POPULATION__227	public class TYPE_DE_POPULATION__227 extends Rubrique { final RubriqueType type = RubriqueType.TYPE_DE_POPULATION__227;}
CODE_D_AFFECTATION__228	public class CODE_D_AFFECTATION__228 extends Rubrique { final RubriqueType type = RubriqueType.CODE_D_AFFECTATION__228;}
PERIODE_D_AFFECTATION__229	public class PERIODE_D_AFFECTATION__229 extends Rubrique { final RubriqueType type = RubriqueType.PERIODE_D_AFFECTATION__229;}
MOTIF_DE_L_ARRÊT_230	public class MOTIF_DE_L_ARRÊT_230 extends Rubrique { final RubriqueType type = RubriqueType.MOTIF_DE_L_ARRÊT_230;}
DATE_DU_DERNIER_JOUR_TRAVAILLE_231	public class DATE_DU_DERNIER_JOUR_TRAVAILLE_231 extends Rubrique { final RubriqueType type = RubriqueType.DATE_DU_DERNIER_JOUR_TRAVAILLE_231;}
DATE_DE_FIN_PREVISIONNELLE_232	public class DATE_DE_FIN_PREVISIONNELLE_232 extends Rubrique { final RubriqueType type = RubriqueType.DATE_DE_FIN_PREVISIONNELLE_232;}
SUBROGATION_233	public class SUBROGATION_233 extends Rubrique { final RubriqueType type = RubriqueType.SUBROGATION_233;}
DATE_DE_DEBUT_DE_SUBROGATION_234	public class DATE_DE_DEBUT_DE_SUBROGATION_234 extends Rubrique { final RubriqueType type = RubriqueType.DATE_DE_DEBUT_DE_SUBROGATION_234;}
DATE_DE_FIN_DE_SUBROGATION_235	public class DATE_DE_FIN_DE_SUBROGATION_235 extends Rubrique { final RubriqueType type = RubriqueType.DATE_DE_FIN_DE_SUBROGATION_235;}
IBAN_236	public class IBAN_236 extends Rubrique { final RubriqueType type = RubriqueType.IBAN_236;}
BIC_237	public class BIC_237 extends Rubrique { final RubriqueType type = RubriqueType.BIC_237;}
DATE_DE_LA_REPRISE_238	public class DATE_DE_LA_REPRISE_238 extends Rubrique { final RubriqueType type = RubriqueType.DATE_DE_LA_REPRISE_238;}
MOTIF_DE_LA_REPRISE_239	public class MOTIF_DE_LA_REPRISE_239 extends Rubrique { final RubriqueType type = RubriqueType.MOTIF_DE_LA_REPRISE_239;}
DATE_DE_L_ACCIDENT_OU_DE_LA_PREMIERE_CONSTATATION_240	public class DATE_DE_L_ACCIDENT_OU_DE_LA_PREMIERE_CONSTATATION_240 extends Rubrique { final RubriqueType type = RubriqueType.DATE_DE_L_ACCIDENT_OU_DE_LA_PREMIERE_CONSTATATION_240;}
DATE_DE_FIN_DU_CONTRAT_241	public class DATE_DE_FIN_DU_CONTRAT_241 extends Rubrique { final RubriqueType type = RubriqueType.DATE_DE_FIN_DU_CONTRAT_241;}
MOTIF_DE_LA_RUPTURE_DU_CONTRAT_242	public class MOTIF_DE_LA_RUPTURE_DU_CONTRAT_242 extends Rubrique { final RubriqueType type = RubriqueType.MOTIF_DE_LA_RUPTURE_DU_CONTRAT_242;}
DATE_DE_NOTIFICATION_DE_LA_RUPTURE_DE_CONTRAT_243	public class DATE_DE_NOTIFICATION_DE_LA_RUPTURE_DE_CONTRAT_243 extends Rubrique { final RubriqueType type = RubriqueType.DATE_DE_NOTIFICATION_DE_LA_RUPTURE_DE_CONTRAT_243;}
DATE_DE_SIGNATURE_DE_LA_CONVENTION_DE_RUPTURE_244	public class DATE_DE_SIGNATURE_DE_LA_CONVENTION_DE_RUPTURE_244 extends Rubrique { final RubriqueType type = RubriqueType.DATE_DE_SIGNATURE_DE_LA_CONVENTION_DE_RUPTURE_244;}
DATE_D_ENGAGEMENT_DE_LA_PROCEDURE_DE_LICENCIEMENT_245	public class DATE_D_ENGAGEMENT_DE_LA_PROCEDURE_DE_LICENCIEMENT_245 extends Rubrique { final RubriqueType type = RubriqueType.DATE_D_ENGAGEMENT_DE_LA_PROCEDURE_DE_LICENCIEMENT_245;}
DERNIER_JOUR_TRAVAILLE_ET_PAYE_AU_SALAIRE_HABITUEL_246	public class DERNIER_JOUR_TRAVAILLE_ET_PAYE_AU_SALAIRE_HABITUEL_246 extends Rubrique { final RubriqueType type = RubriqueType.DERNIER_JOUR_TRAVAILLE_ET_PAYE_AU_SALAIRE_HABITUEL_246;}
TRANSACTION_EN_COURS_247	public class TRANSACTION_EN_COURS_247 extends Rubrique { final RubriqueType type = RubriqueType.TRANSACTION_EN_COURS_247;}
PORTABILITE_CONTRAT_DE_PREVOYANCE_248	public class PORTABILITE_CONTRAT_DE_PREVOYANCE_248 extends Rubrique { final RubriqueType type = RubriqueType.PORTABILITE_CONTRAT_DE_PREVOYANCE_248;}
NOMBRE_D_HEURES_DE_DIF_N_AYANT_PAS_ETE_UTILISEES_249	public class NOMBRE_D_HEURES_DE_DIF_N_AYANT_PAS_ETE_UTILISEES_249 extends Rubrique { final RubriqueType type = RubriqueType.NOMBRE_D_HEURES_DE_DIF_N_AYANT_PAS_ETE_UTILISEES_249;}
NOMBRE_DE_MOIS_DE_PREAVIS_UTILISES_DANS_LE_CADRE_DU_CALCUL_CSP_250	public class NOMBRE_DE_MOIS_DE_PREAVIS_UTILISES_DANS_LE_CADRE_DU_CALCUL_CSP_250 extends Rubrique { final RubriqueType type = RubriqueType.NOMBRE_DE_MOIS_DE_PREAVIS_UTILISES_DANS_LE_CADRE_DU_CALCUL_CSP_250;}
SALAIRE_NET_HORAIRE_DU_SALARIE_251	public class SALAIRE_NET_HORAIRE_DU_SALARIE_251 extends Rubrique { final RubriqueType type = RubriqueType.SALAIRE_NET_HORAIRE_DU_SALARIE_251;}
MONTANT_DE_L_INDEMNITE_DE_PREAVIS_QUI_AURAIT_ETE_VERSEE_252	public class MONTANT_DE_L_INDEMNITE_DE_PREAVIS_QUI_AURAIT_ETE_VERSEE_252 extends Rubrique { final RubriqueType type = RubriqueType.MONTANT_DE_L_INDEMNITE_DE_PREAVIS_QUI_AURAIT_ETE_VERSEE_252;}
STATUT_PARTICULIER_DU_SALARIE_253	public class STATUT_PARTICULIER_DU_SALARIE_253 extends Rubrique { final RubriqueType type = RubriqueType.STATUT_PARTICULIER_DU_SALARIE_253;}
TYPE_REALISATION_ET_PAIEMENT_DU_PREAVIS_254	public class TYPE_REALISATION_ET_PAIEMENT_DU_PREAVIS_254 extends Rubrique { final RubriqueType type = RubriqueType.TYPE_REALISATION_ET_PAIEMENT_DU_PREAVIS_254;}
DATE_DE_DEBUT_DE_PREAVIS_255	public class DATE_DE_DEBUT_DE_PREAVIS_255 extends Rubrique { final RubriqueType type = RubriqueType.DATE_DE_DEBUT_DE_PREAVIS_255;}
DATE_DE_FIN_DE_PREAVIS_256	public class DATE_DE_FIN_DE_PREAVIS_256 extends Rubrique { final RubriqueType type = RubriqueType.DATE_DE_FIN_DE_PREAVIS_256;}
MOTIF_DE_SUSPENSION_257	public class MOTIF_DE_SUSPENSION_257 extends Rubrique { final RubriqueType type = RubriqueType.MOTIF_DE_SUSPENSION_257;}
DATE_DE_DEBUT_DE_LA_SUSPENSION_258	public class DATE_DE_DEBUT_DE_LA_SUSPENSION_258 extends Rubrique { final RubriqueType type = RubriqueType.DATE_DE_DEBUT_DE_LA_SUSPENSION_258;}
DATE_DE_FIN_DE_LA_SUSPENSION_259	public class DATE_DE_FIN_DE_LA_SUSPENSION_259 extends Rubrique { final RubriqueType type = RubriqueType.DATE_DE_FIN_DE_LA_SUSPENSION_259;}
DATE_DE_DEBUT__260	public class DATE_DE_DEBUT__260 extends Rubrique { final RubriqueType type = RubriqueType.DATE_DE_DEBUT__260;}
DATE_DE_FIN__261	public class DATE_DE_FIN__261 extends Rubrique { final RubriqueType type = RubriqueType.DATE_DE_FIN__261;}
MONTANT__262	public class MONTANT__262 extends Rubrique { final RubriqueType type = RubriqueType.MONTANT__262;}
REFERENCE_DU_CONTRAT_DE_PREVOYANCE_263	public class REFERENCE_DU_CONTRAT_DE_PREVOYANCE_263 extends Rubrique { final RubriqueType type = RubriqueType.REFERENCE_DU_CONTRAT_DE_PREVOYANCE_263;}
CODE_ORGANISME_DE_PREVOYANCE_264	public class CODE_ORGANISME_DE_PREVOYANCE_264 extends Rubrique { final RubriqueType type = RubriqueType.CODE_ORGANISME_DE_PREVOYANCE_264;}
CODE_DELEGATAIRE_DE_GESTION_265	public class CODE_DELEGATAIRE_DE_GESTION_265 extends Rubrique { final RubriqueType type = RubriqueType.CODE_DELEGATAIRE_DE_GESTION_265;}
CODE_OPTION_RETENUE_PAR_LE_SALARIE_266	public class CODE_OPTION_RETENUE_PAR_LE_SALARIE_266 extends Rubrique { final RubriqueType type = RubriqueType.CODE_OPTION_RETENUE_PAR_LE_SALARIE_266;}
CODE_POPULATION_DE_RATTACHEMENT_267	public class CODE_POPULATION_DE_RATTACHEMENT_267 extends Rubrique { final RubriqueType type = RubriqueType.CODE_POPULATION_DE_RATTACHEMENT_267;}
DATE_D_AFFILIATION_268	public class DATE_D_AFFILIATION_268 extends Rubrique { final RubriqueType type = RubriqueType.DATE_D_AFFILIATION_268;}
NOMBRE_D’ENFANTS_A_CHARGE__269	public class NOMBRE_D’ENFANTS_A_CHARGE__269 extends Rubrique { final RubriqueType type = RubriqueType.NOMBRE_D’ENFANTS_A_CHARGE__269;}
NOMBRE_D_ADULTES_AYANTS_270	public class NOMBRE_D_ADULTES_AYANTS_270 extends Rubrique { final RubriqueType type = RubriqueType.NOMBRE_D_ADULTES_AYANTS_270;}
NOMBRE_D_AYANTS_271	public class NOMBRE_D_AYANTS_271 extends Rubrique { final RubriqueType type = RubriqueType.NOMBRE_D_AYANTS_271;}
NOMBRE_D_AYANTS_272	public class NOMBRE_D_AYANTS_272 extends Rubrique { final RubriqueType type = RubriqueType.NOMBRE_D_AYANTS_272;}
NOMBRE_D_ENFANTS_AYANTS_273	public class NOMBRE_D_ENFANTS_AYANTS_273 extends Rubrique { final RubriqueType type = RubriqueType.NOMBRE_D_ENFANTS_AYANTS_273;}
IDENTIFIANT_TECHNIQUE_AFFILIATION__274	public class IDENTIFIANT_TECHNIQUE_AFFILIATION__274 extends Rubrique { final RubriqueType type = RubriqueType.IDENTIFIANT_TECHNIQUE_AFFILIATION__274;}
IDENTIFIANT_TECHNIQUE_ADHESION__275	public class IDENTIFIANT_TECHNIQUE_ADHESION__275 extends Rubrique { final RubriqueType type = RubriqueType.IDENTIFIANT_TECHNIQUE_ADHESION__275;}
CODE_REGIME_RETRAITE_COMPLEMENTAIRE_276	public class CODE_REGIME_RETRAITE_COMPLEMENTAIRE_276 extends Rubrique { final RubriqueType type = RubriqueType.CODE_REGIME_RETRAITE_COMPLEMENTAIRE_276;}
DATE_DE_LA_MODIFICATION_277	public class DATE_DE_LA_MODIFICATION_277 extends Rubrique { final RubriqueType type = RubriqueType.DATE_DE_LA_MODIFICATION_277;}
ANCIEN_CODE_ORGANISME_DE_PREVOYANCE_278	public class ANCIEN_CODE_ORGANISME_DE_PREVOYANCE_278 extends Rubrique { final RubriqueType type = RubriqueType.ANCIEN_CODE_ORGANISME_DE_PREVOYANCE_278;}
ANCIEN_CODE_DELEGATAIRE_DE_GESTION_279	public class ANCIEN_CODE_DELEGATAIRE_DE_GESTION_279 extends Rubrique { final RubriqueType type = RubriqueType.ANCIEN_CODE_DELEGATAIRE_DE_GESTION_279;}
REGIME_LOCAL_ALSACE_280	public class REGIME_LOCAL_ALSACE_280 extends Rubrique { final RubriqueType type = RubriqueType.REGIME_LOCAL_ALSACE_280;}
CODE_OPTION__281	public class CODE_OPTION__281 extends Rubrique { final RubriqueType type = RubriqueType.CODE_OPTION__281;}
TYPE__282	public class TYPE__282 extends Rubrique { final RubriqueType type = RubriqueType.TYPE__282;}
DATE_DE_DEBUT_DE_RATTACHEMENT_A_L_OUVRANT_283	public class DATE_DE_DEBUT_DE_RATTACHEMENT_A_L_OUVRANT_283 extends Rubrique { final RubriqueType type = RubriqueType.DATE_DE_DEBUT_DE_RATTACHEMENT_A_L_OUVRANT_283;}
DATE_DE_NAISSANCE__284	public class DATE_DE_NAISSANCE__284 extends Rubrique { final RubriqueType type = RubriqueType.DATE_DE_NAISSANCE__284;}
NOM_DE_FAMILLE__285	public class NOM_DE_FAMILLE__285 extends Rubrique { final RubriqueType type = RubriqueType.NOM_DE_FAMILLE__285;}
NUMERO_D_INSCRIPTION_AU_REPERTOIRE__286	public class NUMERO_D_INSCRIPTION_AU_REPERTOIRE__286 extends Rubrique { final RubriqueType type = RubriqueType.NUMERO_D_INSCRIPTION_AU_REPERTOIRE__286;}
NIR_OUVRANT_287	public class NIR_OUVRANT_287 extends Rubrique { final RubriqueType type = RubriqueType.NIR_OUVRANT_287;}
PRENOMS__288	public class PRENOMS__288 extends Rubrique { final RubriqueType type = RubriqueType.PRENOMS__288;}
CODE_ORGANISME_D_AFFILIATION_A_L_ASSURANCE_MALADIE__289	public class CODE_ORGANISME_D_AFFILIATION_A_L_ASSURANCE_MALADIE__289 extends Rubrique { final RubriqueType type = RubriqueType.CODE_ORGANISME_D_AFFILIATION_A_L_ASSURANCE_MALADIE__289;}
DATE_DE_FIN_DE_RATTACHEMENT_A_L_OUVRANT_290	public class DATE_DE_FIN_DE_RATTACHEMENT_A_L_OUVRANT_290 extends Rubrique { final RubriqueType type = RubriqueType.DATE_DE_FIN_DE_RATTACHEMENT_A_L_OUVRANT_290;}
CODE_DE_BASE_ASSUJETTIE_291	public class CODE_DE_BASE_ASSUJETTIE_291 extends Rubrique { final RubriqueType type = RubriqueType.CODE_DE_BASE_ASSUJETTIE_291;}
DATE_DE_DEBUT_DE_PERIODE_DE_RATTACHEMENT_292	public class DATE_DE_DEBUT_DE_PERIODE_DE_RATTACHEMENT_292 extends Rubrique { final RubriqueType type = RubriqueType.DATE_DE_DEBUT_DE_PERIODE_DE_RATTACHEMENT_292;}
DATE_DE_FIN_DE_PERIODE_DE_RATTACHEMENT_293	public class DATE_DE_FIN_DE_PERIODE_DE_RATTACHEMENT_293 extends Rubrique { final RubriqueType type = RubriqueType.DATE_DE_FIN_DE_PERIODE_DE_RATTACHEMENT_293;}
MONTANT_DE_BASE_ASSUJETTIE_294	public class MONTANT_DE_BASE_ASSUJETTIE_294 extends Rubrique { final RubriqueType type = RubriqueType.MONTANT_DE_BASE_ASSUJETTIE_294;}
IDENTIFIANT_TECHNIQUE_AFFILIATION__295	public class IDENTIFIANT_TECHNIQUE_AFFILIATION__295 extends Rubrique { final RubriqueType type = RubriqueType.IDENTIFIANT_TECHNIQUE_AFFILIATION__295;}
TYPE_DE_COMPOSANT_DE_BASE_ASSUJETTIE_296	public class TYPE_DE_COMPOSANT_DE_BASE_ASSUJETTIE_296 extends Rubrique { final RubriqueType type = RubriqueType.TYPE_DE_COMPOSANT_DE_BASE_ASSUJETTIE_296;}
DATE_DE_DEBUT_DE_PERIODE_DE_RATTACHEMENT_297	public class DATE_DE_DEBUT_DE_PERIODE_DE_RATTACHEMENT_297 extends Rubrique { final RubriqueType type = RubriqueType.DATE_DE_DEBUT_DE_PERIODE_DE_RATTACHEMENT_297;}
DATE_DE_FIN_DE_PERIODE_DE_RATTACHEMENT_298	public class DATE_DE_FIN_DE_PERIODE_DE_RATTACHEMENT_298 extends Rubrique { final RubriqueType type = RubriqueType.DATE_DE_FIN_DE_PERIODE_DE_RATTACHEMENT_298;}
MONTANT_DE_COMPOSANT_DE_BASE_ASSUJETTIE_299	public class MONTANT_DE_COMPOSANT_DE_BASE_ASSUJETTIE_299 extends Rubrique { final RubriqueType type = RubriqueType.MONTANT_DE_COMPOSANT_DE_BASE_ASSUJETTIE_299;}
CODE_DE_COTISATION_300	public class CODE_DE_COTISATION_300 extends Rubrique { final RubriqueType type = RubriqueType.CODE_DE_COTISATION_300;}
IDENTIFIANT_ORGANISME_DE_PROTECTION_SOCIALE_301	public class IDENTIFIANT_ORGANISME_DE_PROTECTION_SOCIALE_301 extends Rubrique { final RubriqueType type = RubriqueType.IDENTIFIANT_ORGANISME_DE_PROTECTION_SOCIALE_301;}
MONTANT_D_ASSIETTE_302	public class MONTANT_D_ASSIETTE_302 extends Rubrique { final RubriqueType type = RubriqueType.MONTANT_D_ASSIETTE_302;}
MONTANT_DE_COTISATION_303	public class MONTANT_DE_COTISATION_303 extends Rubrique { final RubriqueType type = RubriqueType.MONTANT_DE_COTISATION_303;}
CODE_INSEE_COMMUNE_304	public class CODE_INSEE_COMMUNE_304 extends Rubrique { final RubriqueType type = RubriqueType.CODE_INSEE_COMMUNE_304;}
IDENTIFIANT_DU_LIEU_DE_TRAVAIL_305	public class IDENTIFIANT_DU_LIEU_DE_TRAVAIL_305 extends Rubrique { final RubriqueType type = RubriqueType.IDENTIFIANT_DU_LIEU_DE_TRAVAIL_305;}
CODE_APET_306	public class CODE_APET_306 extends Rubrique { final RubriqueType type = RubriqueType.CODE_APET_306;}
NUMERO__EXTENSION__NATURE__LIBELLE_DE_VOIE_307	public class NUMERO__EXTENSION__NATURE__LIBELLE_DE_VOIE_307 extends Rubrique { final RubriqueType type = RubriqueType.NUMERO__EXTENSION__NATURE__LIBELLE_DE_VOIE_307;}
CODE_POSTAL_308	public class CODE_POSTAL_308 extends Rubrique { final RubriqueType type = RubriqueType.CODE_POSTAL_308;}
LOCALITE_309	public class LOCALITE_309 extends Rubrique { final RubriqueType type = RubriqueType.LOCALITE_309;}
CODE_PAYS_310	public class CODE_PAYS_310 extends Rubrique { final RubriqueType type = RubriqueType.CODE_PAYS_310;}
CODE_DE_DISTRIBUTION_A_L_ETRANGER_311	public class CODE_DE_DISTRIBUTION_A_L_ETRANGER_311 extends Rubrique { final RubriqueType type = RubriqueType.CODE_DE_DISTRIBUTION_A_L_ETRANGER_311;}
COMPLEMENT_DE_LA_LOCALISATION_DE_LA_CONSTRUCTION_312	public class COMPLEMENT_DE_LA_LOCALISATION_DE_LA_CONSTRUCTION_312 extends Rubrique { final RubriqueType type = RubriqueType.COMPLEMENT_DE_LA_LOCALISATION_DE_LA_CONSTRUCTION_312;}
SERVICE_DE_DISTRIBUTION__COMPLEMENT_DE_LOCALISATION_DE_LA_VOIE_313	public class SERVICE_DE_DISTRIBUTION__COMPLEMENT_DE_LOCALISATION_DE_LA_VOIE_313 extends Rubrique { final RubriqueType type = RubriqueType.SERVICE_DE_DISTRIBUTION__COMPLEMENT_DE_LOCALISATION_DE_LA_VOIE_313;}
NATURE_JURIDIQUE_314	public class NATURE_JURIDIQUE_314 extends Rubrique { final RubriqueType type = RubriqueType.NATURE_JURIDIQUE_314;}
CODE_INSEE_COMMUNE_315	public class CODE_INSEE_COMMUNE_315 extends Rubrique { final RubriqueType type = RubriqueType.CODE_INSEE_COMMUNE_315;}
TYPE_316	public class TYPE_316 extends Rubrique { final RubriqueType type = RubriqueType.TYPE_316;}
UNITE_DE_MESURE_317	public class UNITE_DE_MESURE_317 extends Rubrique { final RubriqueType type = RubriqueType.UNITE_DE_MESURE_317;}
VALEUR_318	public class VALEUR_318 extends Rubrique { final RubriqueType type = RubriqueType.VALEUR_318;}
NUMERO_DU_CONTRAT_319	public class NUMERO_DU_CONTRAT_319 extends Rubrique { final RubriqueType type = RubriqueType.NUMERO_DU_CONTRAT_319;}
NUMERO_D_INSCRIPTION_AU_REPERTOIRE__320	public class NUMERO_D_INSCRIPTION_AU_REPERTOIRE__320 extends Rubrique { final RubriqueType type = RubriqueType.NUMERO_D_INSCRIPTION_AU_REPERTOIRE__320;}
NOM_DE_FAMILLE__321	public class NOM_DE_FAMILLE__321 extends Rubrique { final RubriqueType type = RubriqueType.NOM_DE_FAMILLE__321;}
NOM_D_USAGE__322	public class NOM_D_USAGE__322 extends Rubrique { final RubriqueType type = RubriqueType.NOM_D_USAGE__322;}
PRENOMS__323	public class PRENOMS__323 extends Rubrique { final RubriqueType type = RubriqueType.PRENOMS__323;}
SEXE__324	public class SEXE__324 extends Rubrique { final RubriqueType type = RubriqueType.SEXE__324;}
DATE_DE_NAISSANCE__325	public class DATE_DE_NAISSANCE__325 extends Rubrique { final RubriqueType type = RubriqueType.DATE_DE_NAISSANCE__325;}
LIEU_DE_NAISSANCE__326	public class LIEU_DE_NAISSANCE__326 extends Rubrique { final RubriqueType type = RubriqueType.LIEU_DE_NAISSANCE__326;}
NUMERO__EXTENSION__NATURE_ET_LIBELLE_DE_LA_VOIE__327	public class NUMERO__EXTENSION__NATURE_ET_LIBELLE_DE_LA_VOIE__327 extends Rubrique { final RubriqueType type = RubriqueType.NUMERO__EXTENSION__NATURE_ET_LIBELLE_DE_LA_VOIE__327;}
CODE_POSTAL__328	public class CODE_POSTAL__328 extends Rubrique { final RubriqueType type = RubriqueType.CODE_POSTAL__328;}
LOCALITE__329	public class LOCALITE__329 extends Rubrique { final RubriqueType type = RubriqueType.LOCALITE__329;}
CODE_PAYS__330	public class CODE_PAYS__330 extends Rubrique { final RubriqueType type = RubriqueType.CODE_PAYS__330;}
CODE_DE_DISTRIBUTION_A_L_ETRANGER__331	public class CODE_DE_DISTRIBUTION_A_L_ETRANGER__331 extends Rubrique { final RubriqueType type = RubriqueType.CODE_DE_DISTRIBUTION_A_L_ETRANGER__331;}
COMPLEMENT_DE_LA_LOCALISATION_DE_LA_CONSTRUCTION__332	public class COMPLEMENT_DE_LA_LOCALISATION_DE_LA_CONSTRUCTION__332 extends Rubrique { final RubriqueType type = RubriqueType.COMPLEMENT_DE_LA_LOCALISATION_DE_LA_CONSTRUCTION__332;}
SERVICE_DE_DISTRIBUTION__COMPLEMENT_DE_LOCALISATION_DE_LA_VOIE__333	public class SERVICE_DE_DISTRIBUTION__COMPLEMENT_DE_LOCALISATION_DE_LA_VOIE__333 extends Rubrique { final RubriqueType type = RubriqueType.SERVICE_DE_DISTRIBUTION__COMPLEMENT_DE_LOCALISATION_DE_LA_VOIE__333;}
ADRESSE_MEL__334	public class ADRESSE_MEL__334 extends Rubrique { final RubriqueType type = RubriqueType.ADRESSE_MEL__334;}
MATRICULE_DE_L_INDIVIDU_DANS_L_ENTREPRISE__335	public class MATRICULE_DE_L_INDIVIDU_DANS_L_ENTREPRISE__335 extends Rubrique { final RubriqueType type = RubriqueType.MATRICULE_DE_L_INDIVIDU_DANS_L_ENTREPRISE__335;}
STATUT_DU_SALARIE__CONVENTIONNEL_336	public class STATUT_DU_SALARIE__CONVENTIONNEL_336 extends Rubrique { final RubriqueType type = RubriqueType.STATUT_DU_SALARIE__CONVENTIONNEL_336;}
CODE_STATUT_CATEGORIEL_RETRAITE_COMPLEMENTAIRE_OBLIGATOIRE__337	public class CODE_STATUT_CATEGORIEL_RETRAITE_COMPLEMENTAIRE_OBLIGATOIRE__337 extends Rubrique { final RubriqueType type = RubriqueType.CODE_STATUT_CATEGORIEL_RETRAITE_COMPLEMENTAIRE_OBLIGATOIRE__337;}
TYPE__338	public class TYPE__338 extends Rubrique { final RubriqueType type = RubriqueType.TYPE__338;}
CODE_DE_BASE_SPECIFIQUE__339	public class CODE_DE_BASE_SPECIFIQUE__339 extends Rubrique { final RubriqueType type = RubriqueType.CODE_DE_BASE_SPECIFIQUE__339;}
MONTANT__340	public class MONTANT__340 extends Rubrique { final RubriqueType type = RubriqueType.MONTANT__340;}
DATE_DE_DEBUT_DE_PERIODE_DE_RATTACHEMENT__341	public class DATE_DE_DEBUT_DE_PERIODE_DE_RATTACHEMENT__341 extends Rubrique { final RubriqueType type = RubriqueType.DATE_DE_DEBUT_DE_PERIODE_DE_RATTACHEMENT__341;}
DATE_DE_FIN_DE_PERIODE_DE_RATTACHEMENT__342	public class DATE_DE_FIN_DE_PERIODE_DE_RATTACHEMENT__342 extends Rubrique { final RubriqueType type = RubriqueType.DATE_DE_FIN_DE_PERIODE_DE_RATTACHEMENT__342;}
NOMBRE_TOTAL_DE_RUBRIQUES_343	public class NOMBRE_TOTAL_DE_RUBRIQUES_343 extends Rubrique { final RubriqueType type = RubriqueType.NOMBRE_TOTAL_DE_RUBRIQUES_343;}
NOMBRE_DE_DSN_344	public class NOMBRE_DE_DSN_344 extends Rubrique { final RubriqueType type = RubriqueType.NOMBRE_DE_DSN_344;}